abaction	su pha binh
abactor	abactor
abaddon	abaddon
abalienate	abalienate
abalienation	abalienation
abalone	bao ngu
abanga	ho co the
abase	abe
abaser	abaser
abasing	hau het trong so ho
abassi	Abbasi
abassis	abassis
abated	nguoi ngoai
abater	ban ha
abating	lam diu di
abatvoix	abatvoix
abawed	Abboud
abaxial	thuoc ve mat tru
abaxile	abaxile
abb	abb
abb wool	len abb
abba	abba
abbacy	abbacy
abbatical	abbatical